1111111111111111111111111111111111
1E0000000000000C00000C000000000001
1010010100100000101001000000010101
1010010010101010001001000000010101
101001010010000010100100C0C0010101
1010000010101010000001000000010101
10100101001000E0101001000H00010101
1010010010101010001001000000010101
10100101000000001000010000H0010101
1010010010101010001001000000010101
1P0000000C00C000C000C0C0000C0C00C1
1111111111111111111111111111111111